{
  "name": "crossfire",
  "tiles": [
    "....................",
    "....................",
    "....................",
    "....................",
    "..####........####..",
    "....................",
    "....................",
    "........####........",
    "....................",
    "....................",
    "####............####",
    "....................",
    "....................",
    "#########..#########",
    "#########..#########"
  ],
  "spawns": [
    { "x": 64, "y": 56 },
    { "x": 256, "y": 56 },
    { "x": 32, "y": 152 },
    { "x": 288, "y": 152 }
  ],
  "chestSpots": [
    { "x": 160, "y": 108 },
    { "x": 32, "y": 156 },
    { "x": 288, "y": 156 }
  ]
}
